# Symbol	Company
AAPL	Apple
AMGN	Amgen
AMZN	Amazon
AXP	American Express
BA	Boeing
CAT	Caterpillar
CRM	Salesforce
CSCO	Cisco
CVX	Chevron
DIS	Disney
GS	Goldman Sachs
HD	Home Depot
HON	Honeywell
IBM	IBM
JNJ	Johnson & Johnson
JPM	JPMorgan Chase
KO	Coca-Cola
MCD	McDonald's
MMM	3M
MRK	Merck
MSFT	Microsoft
NKE	Nike
NVDA	Nvidia
PG	Procter & Gamble
SHW	Sherwin-Williams
TRV	Travelers Companies, Inc.
UNH	UnitedHealth Group
V	Visa
VZ	Verizon
WMT	Walmart
