# Symbol	Company
A	Agilent Technologies
AAPL	Apple Inc.
ABBV	AbbVie
ABNB	Airbnb
ABT	Abbott Laboratories
ACGL	Arch Capital Group
ACN	Accenture
ADBE	Adobe Inc.
ADI	Analog Devices
ADM	Archer Daniels Midland
ADP	Automatic Data Processing
ADSK	Autodesk
AEE	Ameren
AEP	American Electric Power
AES	AES Corporation
AFL	Aflac
AIG	American International Group
AIZ	Assurant
AJG	Arthur J. Gallagher & Co.
AKAM	Akamai Technologies
ALB	Albemarle Corporation
ALGN	Align Technology
ALL	Allstate
ALLE	Allegion
AMAT	Applied Materials
AMCR	Amcor
AMD	Advanced Micro Devices
AME	Ametek
AMGN	Amgen
AMP	Ameriprise Financial
AMT	American Tower
AMZN	Amazon
ANET	Arista Networks
AON	Aon plc
AOS	A. O. Smith
APA	APA Corporation
APD	Air Products
APH	Amphenol
APO	Apollo Global Management
APTV	Aptiv
ARE	Alexandria Real Estate Equities
ATO	Atmos Energy
AVB	AvalonBay Communities
AVGO	Broadcom
AVY	Avery Dennison
AWK	American Water Works
AXON	Axon Enterprise
AXP	American Express
AZO	AutoZone
BA	Boeing
BAC	Bank of America
BALL	Ball Corporation
BAX	Baxter International
BBY	Best Buy
BDX	Becton Dickinson
BEN	Franklin Resources
BF-B	Brown–Forman
BG	Bunge Global
BIIB	Biogen
BK	BNY Mellon
BKNG	Booking Holdings
BKR	Baker Hughes
BLDR	Builders FirstSource
BLK	BlackRock
BMY	Bristol Myers Squibb
BR	Broadridge Financial Solutions
BRK-B	Berkshire Hathaway
BRO	Brown & Brown
BSX	Boston Scientific
BX	Blackstone Inc.
BXP	BXP, Inc.
C	Citigroup
CAG	Conagra Brands
CAH	Cardinal Health
CARR	Carrier Global
CAT	Caterpillar Inc.
CB	Chubb Limited
CBOE	Cboe Global Markets
CBRE	CBRE Group
CCI	Crown Castle
CCL	Carnival
CDNS	Cadence Design Systems
CDW	CDW Corporation
CEG	Constellation Energy
CF	CF Industries
CFG	Citizens Financial Group
CHD	Church & Dwight
CHRW	C.H. Robinson
CHTR	Charter Communications
CI	Cigna
CINF	Cincinnati Financial
CL	Colgate-Palmolive
CLX	Clorox
CMCSA	Comcast
CME	CME Group
CMG	Chipotle Mexican Grill
CMI	Cummins
CMS	CMS Energy
CNC	Centene Corporation
CNP	CenterPoint Energy
COF	Capital One
COIN	Coinbase
COO	Cooper Companies (The)
COP	ConocoPhillips
COR	Cencora
COST	Costco
CPAY	Corpay
CPB	Campbell's Company (The)
CPRT	Copart
CPT	Camden Property Trust
CRL	Charles River Laboratories
CRM	Salesforce
CRWD	CrowdStrike
CSCO	Cisco
CSGP	CoStar Group
CSX	CSX Corporation
CTAS	Cintas
CTRA	Coterra
CTSH	Cognizant
CTVA	Corteva
CVS	CVS Health
CVX	Chevron Corporation
CZR	Caesars Entertainment
D	Dominion Energy
DAL	Delta Air Lines
DASH	DoorDash
DAY	Dayforce
DD	DuPont
DDOG	Datadog
DE	Deere & Company
DECK	Deckers Brands
DELL	Dell Technologies
DG	Dollar General
DGX	Quest Diagnostics
DHI	D. R. Horton
DHR	Danaher Corporation
DIS	Walt Disney Company (The)
DLR	Digital Realty
DLTR	Dollar Tree
DOC	Healthpeak Properties
DOV	Dover Corporation
DOW	Dow Inc.
DPZ	Domino's
DRI	Darden Restaurants
DTE	DTE Energy
DUK	Duke Energy
DVA	DaVita
DVN	Devon Energy
DXCM	Dexcom
EA	Electronic Arts
EBAY	eBay Inc.
ECL	Ecolab
ED	Consolidated Edison
EFX	Equifax
EG	Everest Group
EIX	Edison International
EL	Estée Lauder Companies (The)
ELV	Elevance Health
EMN	Eastman Chemical Company
EMR	Emerson Electric
ENPH	Enphase Energy
EOG	EOG Resources
EPAM	EPAM Systems
EQIX	Equinix
EQR	Equity Residential
EQT	EQT Corporation
ERIE	Erie Indemnity
ES	Eversource Energy
ESS	Essex Property Trust
ETN	Eaton Corporation
ETR	Entergy
EVRG	Evergy
EW	Edwards Lifesciences
EXC	Exelon
EXE	Expand Energy
EXPD	Expeditors International
EXPE	Expedia Group
EXR	Extra Space Storage
F	Ford Motor Company
FANG	Diamondback Energy
FAST	Fastenal
FCX	Freeport-McMoRan
FDS	FactSet
FDX	FedEx
FE	FirstEnergy
FFIV	F5, Inc.
FI	Fiserv
FICO	Fair Isaac
FIS	Fidelity National Information Services
FITB	Fifth Third Bancorp
FOX	Fox Corporation (Class B)
FOXA	Fox Corporation (Class A)
FRT	Federal Realty Investment Trust
FSLR	First Solar
FTNT	Fortinet
FTV	Fortive
GD	General Dynamics
GDDY	GoDaddy
GE	GE Aerospace
GEHC	GE HealthCare
GEN	Gen Digital
GEV	GE Vernova
GILD	Gilead Sciences
GIS	General Mills
GL	Globe Life
GLW	Corning Inc.
GM	General Motors
GNRC	Generac
GOOG	Alphabet Inc. (Class C)
GOOGL	Alphabet Inc. (Class A)
GPC	Genuine Parts Company
GPN	Global Payments
GRMN	Garmin
GS	Goldman Sachs
GWW	W. W. Grainger
HAL	Halliburton
HAS	Hasbro
HBAN	Huntington Bancshares
HCA	HCA Healthcare
HD	Home Depot (The)
HIG	Hartford (The)
HII	Huntington Ingalls Industries
HLT	Hilton Worldwide
HOLX	Hologic
HON	Honeywell
HPE	Hewlett Packard Enterprise
HPQ	HP Inc.
HRL	Hormel Foods
HSIC	Henry Schein
HST	Host Hotels & Resorts
HSY	Hershey Company (The)
HUBB	Hubbell Incorporated
HUM	Humana
HWM	Howmet Aerospace
IBKR	Interactive Brokers
IBM	IBM
ICE	Intercontinental Exchange
IDXX	Idexx Laboratories
IEX	IDEX Corporation
IFF	International Flavors & Fragrances
INCY	Incyte
INTC	Intel
INTU	Intuit
INVH	Invitation Homes
IP	International Paper
IPG	Interpublic Group of Companies (The)
IQV	IQVIA
IR	Ingersoll Rand
IRM	Iron Mountain
ISRG	Intuitive Surgical
IT	Gartner
ITW	Illinois Tool Works
IVZ	Invesco
J	Jacobs Solutions
JBHT	J.B. Hunt
JBL	Jabil
JCI	Johnson Controls
JKHY	Jack Henry & Associates
JNJ	Johnson & Johnson
JPM	JPMorgan Chase
K	Kellanova
KDP	Keurig Dr Pepper
KEY	KeyCorp
KEYS	Keysight Technologies
KHC	Kraft Heinz
KIM	Kimco Realty
KKR	KKR & Co.
KLAC	KLA Corporation
KMB	Kimberly-Clark
KMI	Kinder Morgan
KMX	CarMax
KO	Coca-Cola Company (The)
KR	Kroger
KVUE	Kenvue
L	Loews Corporation
LDOS	Leidos
LEN	Lennar
LH	Labcorp
LHX	L3Harris
LII	Lennox International
LIN	Linde plc
LKQ	LKQ Corporation
LLY	Lilly (Eli)
LMT	Lockheed Martin
LNT	Alliant Energy
LOW	Lowe's
LRCX	Lam Research
LULU	Lululemon Athletica
LUV	Southwest Airlines
LVS	Las Vegas Sands
LW	Lamb Weston
LYB	LyondellBasell
LYV	Live Nation Entertainment
MA	Mastercard
MAA	Mid-America Apartment Communities
MAR	Marriott International
MAS	Masco
MCD	McDonald's
MCHP	Microchip Technology
MCK	McKesson Corporation
MCO	Moody's Corporation
MDLZ	Mondelez International
MDT	Medtronic
MET	MetLife
META	Meta Platforms
MGM	MGM Resorts
MHK	Mohawk Industries
MKC	McCormick & Company
MKTX	MarketAxess
MLM	Martin Marietta Materials
MMC	Marsh McLennan
MMM	3M
MNST	Monster Beverage
MO	Altria
MOH	Molina Healthcare
MOS	Mosaic Company (The)
MPC	Marathon Petroleum
MPWR	Monolithic Power Systems
MRK	Merck & Co.
MRNA	Moderna
MS	Morgan Stanley
MSCI	MSCI Inc.
MSFT	Microsoft
MSI	Motorola Solutions
MTB	M&T Bank
MTCH	Match Group
MTD	Mettler Toledo
MU	Micron Technology
NCLH	Norwegian Cruise Line Holdings
NDAQ	Nasdaq, Inc.
NDSN	Nordson Corporation
NEE	NextEra Energy
NEM	Newmont
NFLX	Netflix
NI	NiSource
NKE	Nike, Inc.
NOC	Northrop Grumman
NOW	ServiceNow
NRG	NRG Energy
NSC	Norfolk Southern
NTAP	NetApp
NTRS	Northern Trust
NUE	Nucor
NVDA	Nvidia
NVR	NVR, Inc.
NWS	News Corp (Class B)
NWSA	News Corp (Class A)
NXPI	NXP Semiconductors
O	Realty Income
ODFL	Old Dominion
OKE	Oneok
OMC	Omnicom Group
ON	ON Semiconductor
ORCL	Oracle Corporation
ORLY	O’Reilly Automotive
OTIS	Otis Worldwide
OXY	Occidental Petroleum
PANW	Palo Alto Networks
PAYC	Paycom
PAYX	Paychex
PCAR	Paccar
PCG	PG&E Corporation
PEG	Public Service Enterprise Group
PEP	PepsiCo
PFE	Pfizer
PFG	Principal Financial Group
PG	Procter & Gamble
PGR	Progressive Corporation
PH	Parker Hannifin
PHM	PulteGroup
PKG	Packaging Corporation of America
PLD	Prologis
PLTR	Palantir Technologies
PM	Philip Morris International
PNC	PNC Financial Services
PNR	Pentair
PNW	Pinnacle West Capital
PODD	Insulet Corporation
POOL	Pool Corporation
PPG	PPG Industries
PPL	PPL Corporation
PRU	Prudential Financial
PSA	Public Storage
PSKY	Paramount Skydance Corporation
PSX	Phillips 66
PTC	PTC Inc.
PWR	Quanta Services
PYPL	PayPal
QCOM	Qualcomm
RCL	Royal Caribbean Group
REG	Regency Centers
REGN	Regeneron Pharmaceuticals
RF	Regions Financial Corporation
RJF	Raymond James Financial
RL	Ralph Lauren Corporation
RMD	ResMed
ROK	Rockwell Automation
ROL	Rollins, Inc.
ROP	Roper Technologies
ROST	Ross Stores
RSG	Republic Services
RTX	RTX Corporation
RVTY	Revvity
SBAC	SBA Communications
SBUX	Starbucks
SCHW	Charles Schwab Corporation
SHW	Sherwin-Williams
SJM	J.M. Smucker Company (The)
SLB	Schlumberger
SMCI	Supermicro
SNA	Snap-on
SNPS	Synopsys
SO	Southern Company
SOLV	Solventum
SPG	Simon Property Group
SPGI	S&P Global
SRE	Sempra
STE	Steris
STLD	Steel Dynamics
STT	State Street Corporation
STX	Seagate Technology
STZ	Constellation Brands
SW	Smurfit Westrock
SWK	Stanley Black & Decker
SWKS	Skyworks Solutions
SYF	Synchrony Financial
SYK	Stryker Corporation
SYY	Sysco
T	AT&T
TAP	Molson Coors Beverage Company
TDG	TransDigm Group
TDY	Teledyne Technologies
TECH	Bio-Techne
TEL	TE Connectivity
TER	Teradyne
TFC	Truist Financial
TGT	Target Corporation
TJX	TJX Companies
TKO	TKO Group Holdings
TMO	Thermo Fisher Scientific
TMUS	T-Mobile US
TPL	Texas Pacific Land Corporation
TPR	Tapestry, Inc.
TRGP	Targa Resources
TRMB	Trimble Inc.
TROW	T. Rowe Price
TRV	Travelers Companies (The)
TSCO	Tractor Supply
TSLA	Tesla, Inc.
TSN	Tyson Foods
TT	Trane Technologies
TTD	Trade Desk (The)
TTWO	Take-Two Interactive
TXN	Texas Instruments
TXT	Textron
TYL	Tyler Technologies
UAL	United Airlines Holdings
UBER	Uber
UDR	UDR, Inc.
UHS	Universal Health Services
ULTA	Ulta Beauty
UNH	UnitedHealth Group
UNP	Union Pacific Corporation
UPS	United Parcel Service
URI	United Rentals
USB	U.S. Bancorp
V	Visa Inc.
VICI	Vici Properties
VLO	Valero Energy
VLTO	Veralto
VMC	Vulcan Materials Company
VRSK	Verisk Analytics
VRSN	Verisign
VRTX	Vertex Pharmaceuticals
VST	Vistra Corp.
VTR	Ventas
VTRS	Viatris
VZ	Verizon
WAB	Wabtec
WAT	Waters Corporation
WBD	Warner Bros. Discovery
WDAY	Workday, Inc.
WDC	Western Digital
WEC	WEC Energy Group
WELL	Welltower
WFC	Wells Fargo
WM	Waste Management
WMB	Williams Companies
WMT	Walmart
WRB	W. R. Berkley Corporation
WSM	Williams-Sonoma, Inc.
WST	West Pharmaceutical Services
WTW	Willis Towers Watson
WY	Weyerhaeuser
WYNN	Wynn Resorts
XEL	Xcel Energy
XOM	ExxonMobil
XYL	Xylem Inc.
XYZ	Block, Inc.
YUM	Yum! Brands
ZBH	Zimmer Biomet
ZBRA	Zebra Technologies
ZTS	Zoetis
